11111111111
100000C00V1
1CV0000H001
1C00E00P001
100C00C0C01
11111111111
