111111111111111111111111111111
1000P0000000000C0000C0111100E1
1111111100C00000000010111000C1
1C00000000C000C000001000001111
111111111111111111111111111111
